NO ./textures/A.xpm
SO ./textures/B.xpm
WE ./textures/C.xpm
EA ./textures/D.xpm

F 86,125,70
C 132,106,235

11111N
110101
101001
110001
111111
