NO ./textures/A.xpm
SO ./textures/B.xpm
WE ./textures/C.xpm
EA ./textures/D.xpm

F 86,125,70
C 132,106,235

1111111111111111111
110101111111111
101001111
110N0000
1111111111111111111
