NO ./textures/A.xpm
SO ./textures/B.xpm
WE ./textures/C.xpm
EA ./textures/D.xpm

F 86,125,70
C 132,106,235

111111
100101 X
101001
1100N1
111111
