NO ./textures/A.xpm
SO ./textures/B.xpm
WE ./textures/C.xpm
EA ./textures/D.xpm

F 86,125,70
C 132,106,235

1111 1111
1101 11N1
1011 1001
1101 1001
1111 1111
